%%%%
%  %
% .%
%%%%
Parameters
draw 40
discount 1
InitPosition
1,1
InitPredicates
