%%%%%%%%%%
%  %   . %
% % %  % %
%%   % _ %
%        %
%  %  %  %
%        %
%    %   %
%        %
%%%%%%%%%%
Parameters
draw 40
discount 1
InitPosition
8,6
InitPredicates
