%%%%%%%%%%
%      % %
%     __ %
%       %%
%_%      %
%     .  %
%      % %
%        %
%      % %
%%%%%%%%%%
Parameters
draw 40
discount 1
InitPosition
5,4
InitPredicates
