%%%%%%%%%%
%  _ %%  %
% %   _  %
%_    %  %
%_      _%
%%   _   %
%     _ %%
%   %._  %
%  %%    %
%%%%%%%%%%
Parameters
draw 40
discount 1
InitPosition
2,7
InitPredicates
