%%%%%%%%%%
%  _  _  %
%%%      %
% %  %   %
%        %
%   %  _ %
%        %
%  _    _%
%_.%     %
%%%%%%%%%%
Parameters
draw 40
discount 1
InitPosition
6,4
InitPredicates
