%%%%%%%%%%
%_.      %
%    _ _ %
%     %  %
%    _   %
%     __%%
% _     _%
%    %   %
%        %
%%%%%%%%%%
Parameters
draw 40
discount 1
InitPosition
7,8
InitPredicates
