%%%%%%%%%%
%_ %    _%
% %     %%
% % ._   %
%_  _ __%%
%   %   _%
% _ _   %%
%      _ %
%        %
%%%%%%%%%%
Parameters
draw 40
discount 1
InitPosition
7,2
InitPredicates
