%%%%%%%%%%
%        %
% %      %
%     _  %
%_       %
%    % _%%
%__      %
% %.  _  %
%       %%
%%%%%%%%%%
Parameters
draw 40
discount 1
InitPosition
6,8
InitPredicates
