%%%%%%%%%%
%      %_%
% %     _%
% % __   %
%  %  _  %
%   %    %
% _   _  %
%.  % _  %
%      % %
%%%%%%%%%%
Parameters
draw 40
discount 1
InitPosition
4,1
InitPredicates
