%%%%%%%%%%
%    _ % %
%   _  % %
%.  %   %%
%%       %
%   _    %
%  %     %
%  _%    %
%%       %
%%%%%%%%%%
Parameters
draw 40
discount 1
InitPosition
6,2
InitPredicates
