%%%%%%%%%%
%      _ %
% _ __   %
%        %
%    .  %%
% %      %
%  _     %
%      % %
%        %
%%%%%%%%%%
Parameters
draw 40
discount 1
InitPosition
3,6
InitPredicates
