%%%%%%%%%%
%  _     %
%%  . % %%
% %   %  %
%   %    %
%        %
%  %     %
% %% %  _%
%        %
%%%%%%%%%%
Parameters
draw 40
discount 1
InitPosition
1,5
InitPredicates
