%%%%%%%%%%
%        %
%    %   %
% _      %
%      % %
%   %    %
%%     % %
%  .     %
% %    _ %
%%%%%%%%%%
Parameters
draw 40
discount 1
InitPosition
6,5
InitPredicates
