%%%%%%%%%%
%%   %   %
%       _%
%        %
%        %
%   _  %_%
% .  % % %
%   _    %
%_  __   %
%%%%%%%%%%
Parameters
draw 40
discount 1
InitPosition
5,1
InitPredicates
