%%%%%%%%%%
%  __ % _%
%        %
%   _. % %
%    %   %
%       %%
%__      %
%        %
%%     _ %
%%%%%%%%%%
Parameters
draw 40
discount 1
InitPosition
8,4
InitPredicates
