%%%%%%%%%%
%      __%
%   _   _%
%  .     %
%  %     %
%        %
%   _    %
%    _%_ %
% _      %
%%%%%%%%%%
Parameters
draw 40
discount 1
InitPosition
3,5
InitPredicates
