%%%%%%%%%%
%        %
%  %%  % %
%   _   %%
% %      %
%    %  .%
%        %
% _ _    %
% _      %
%%%%%%%%%%
Parameters
draw 40
discount 1
InitPosition
3,7
InitPredicates
