%%%%%%%%%%
%        %
%     _  %
%  _ .   %
%        %
%__ %   %%
%      % %
%    %%  %
%   _  %%%
%%%%%%%%%%
Parameters
draw 40
discount 1
InitPosition
6,6
InitPredicates
