%%%%%%%%%%
%  _%__  %
%  %     %
%  %     %
%.       %
%_%%  %  %
%     %  %
%_  %__% %
% _   _ %%
%%%%%%%%%%
Parameters
draw 40
discount 1
InitPosition
4,8
InitPredicates
