%%%%%%%%%%
%        %
%  %  % %%
%__  %   %
%   %% %_%
%.     _ %
%   %%  %%
%  _   % %
%  %     %
%%%%%%%%%%
Parameters
draw 40
discount 1
InitPosition
8,5
InitPredicates
