%%%%%%%%%%
%    _   %
%   % .  %
%  %     %
% %%   __%
%%_ _    %
% _  %   %
%   % _  %
%%   _   %
%%%%%%%%%%
Parameters
draw 40
discount 1
InitPosition
5,5
InitPredicates
