%%%%%%%%%%
%        %
%%  _    %
%%    _  %
%  %  %  %
%.      %%
%      % %
%        %
%_   %   %
%%%%%%%%%%
Parameters
draw 40
discount 1
InitPosition
5,7
InitPredicates
