%%%%%%%%%%
%        %
%      % %
%%_._ __ %
%%  %  _ %
%      _ %
%       %%
%        %
%    %   %
%%%%%%%%%%
Parameters
draw 40
discount 1
InitPosition
2,6
InitPredicates
