%%%%%%%%%%
%  %     %
%   %_ % %
%%% _ _ %%
% _   .  %
% _ _ _  %
%        %
%    % __%
%   %    %
%%%%%%%%%%
Parameters
draw 40
discount 1
InitPosition
8,8
InitPredicates
