%%%%%%%%%%
%        %
%  %     %
%        %
%   %%   %
%   %    %
%      __%
%     _  %
% %._    %
%%%%%%%%%%
Parameters
draw 40
discount 1
InitPosition
7,1
InitPredicates
