%%%%%%%%%%
%     _  %
%        %
%        %
%       _%
%% %%.  %%
%  __    %
%        %
%        %
%%%%%%%%%%
Parameters
draw 40
discount 1
InitPosition
4,5
InitPredicates
